{
	"configBoolean": true,
	"configString": "texte d'exemple",
	"configNumber": 3.5,
	"levelDesign": [
		{
			"par": 6,
			"locked": false,
			"map": [
				"######",
				"#@$ .#",
				"### #",
				"###-#",
				"### #",
				"#####",
				"### #",
				"###$#",
				"###.#"
			]
		},
		{
			"par": 20,
			"locked": true,
			"map": [
				"",
				"########",
				"###@#  #",
				"## $#. #",
				"#   $  #",
				"# - #  #",
				"#  .# #",
				"#######",
				""
			]
		},
		{
			"par": 90,
			"locked": true,
			"map": [
				"#########",
				"#   ....#",
				"####    #",
				"#  $    #",
				"# $ $####",
				"# -$@ #",
				"#     #",
				"#######",
				""
			]
		},
		{
			"par": 50,
			"locked": true,
			"map": [
				"########",
				"#  #   #",
				"#   $  #",
				"##$## ##",
				"# -.   #",
				"#  . $ #",
				"# @.   #",
				"########",
				""
			]
		},
		{
			"par": 85,
			"locked": true,
			"map": [
				"",
				"#######",
				"#.  ..#",
				"###.###",
				"#  $  #",
				"# $ $ #",
				"# @$- #",
				"#     #",
				"#######"
			]
		},
		{
			"par": 85,
			"locked": true,
			"map": [
				"###########",
				"#      #  #",
				"# @ - $   #",
				"#      #. #",
				"######  ###",
				"# #  #    #",
				"#    # $  #",
				"#.#   $   #",
				"### .######",
				"######"
			]
		},
		{
			"par": 184,
			"locked": true,
			"map": [
				"##########",
				"#        #",
				"# @$$$ - #",
				"##     ###",
				"## ####  #",
				"## ## #  #",
				"#     #. #",
				"#  #  -. #",
				"## #  #. #",
				"##########"
			]
		},
		{
			"par": 346,
			"locked": true,
			"map": [
				"###########",
				"####      #",
				"#### $$$  #",
				"####$#  $ #",
				"####   -  #",
				"#..# # ####",
				"#.  -  #",
				"#..  @ #",
				"########",
				""
			]
		},
		{
			"par": 90,
			"locked": true,
			"map": [
				"########",
				"##     #",
				"## #####",
				"## #   #",
				"## #@  ###",
				"## # $$  #",
				"## # $ # #",
				"#  # ### #",
				"#  ...   #",
				"##  ######",
				"##########"
			]
		},
		{
			"par": 90,
			"locked": true,
			"map": [
				"         ",
				"         ",
				"         ",
				"         ",
				"         ",
				"         ",
				"         ",
				"         ",
				"         "
			]
		}
	]
}